1N 1N 1N 1N 1N 0S 1N 1N 1N 1N 1N 1N 1N 1N 1N
1N 0I 0N 0N 0N 0I 0N 0I 0N 0N 0N 0I 1N 0I 1N
1N 0N 1N 1N 1N 1N 1N 0N 1N 1N 1N 0N 1N 0N 1N
1N 0I 0N 0I 1N 0I 0N 0I 0N 0I 1N 0I 0N 0I 1N
1N 0N 1N 0N 1N 0N 1N 1N 1N 0N 1N 0N 1N 1N 1N
1N 0I 1N 0N 1N 0I 0N 0I 1N 0N 1N 0I 0N 0I 1N
1N 1N 1N 0N 1N 0N 1N 0N 1N 0N 1N 1N 1N 0N 1N
1N 0I 0N 0I 0N 0I 1N 0N 1N 0I 0N 0N 0N 0I 1N
1N 0N 1N 1N 1N 0N 1N 0N 1N 0N 1N 1N 1N 1N 1N
1N 0I 1N 0I 0N 0I 1N 0I 0N 0I 0N 0I 0N 0I 1N
1N 1N 1N 0N 1N 1N 1N 1N 1N 1N 1N 0N 1N 0N 1N
1N 0I 1N 0I 0N 0N 0N 0I 0N 0N 0N 0I 1N 0N 1N
1N 0N 1N 1N 1N 1N 1N 0N 1N 1N 1N 1N 1N 0N 1N
1N 0I 0N 0N 0N 0N 0N 0I 0N 0N 0N 0N 0N 0I 1N
1N 1N 1N 1N 1N 1N 1N 0F 1N 1N 1N 1N 1N 1N 1N
